11111111111111111
10010C0100C111E01
1P010011001111101
1101!000011C00001
11001110011110111
1001110C000000111
10000C0000000C0!1
11111111111111111