111111111111111111111111
110100000000P10110000001
110000C0!000000000001111
10!100000000010100100101
111100111110000C00000001
11110111100001!1001001!1
111101C1!10!10100!100111
110000C00!0000!000001111
1001!0000!00101001!00101
111100111110000C00000001
11110!1110000!01001!01!1
111101C1!1!001010010!111
1!000000111E000000000001
111111111111111111111111
