111111111111111
1C000P1100000E1
10C1111100C0001
100000C11111001
1111110000C0011
111111111111111