11111111111
10000000001
10000000111
10P001111
100E0C111
111111111